........................................
........................................
........................................
........................................
........................................
...............C.C......................
......?..P....#####....B................
........................................
........................................
..M..C.C............G.........G.......E.
########################..##############
########################..##############
